d01d01d01d01d01d01d01d01d01d01d01d01d01d01d01d01d01d01d01d01d01d01d01d01d01d01d01d01d01d01d01d01d01d01d01d01d01d01d01d01d01d01d01d01d01d01d01d01d01d01d01d01
d01d01d01d06d04d04d04d04d04d07d01d01d01d01d01d01d01d01d01d01d01d01d01d01d01d01d01d01d01d01d01d01d01d01d01d01d01d01d01d01d01d01d01d01d01d01d01d01d01d01d01d01
d01d01d01d02w02w02w02w02w02d03d01d01d01d01d01d01d01d01d01d01d01d01d01d01d01d01d01d01d01d01d01d01d01d01d01d01d01d01d01d01d01d01d01d01d01d01d01d01d01d01d01d01
d01d01d01d02w01w01w01w01w01d03d01d01d01d01d01d01d01d01d01d01d01d01d01d01d01d01d01d01d01d01d01d01d01d01d01d01d01d01d01d01d01d01d01d01d01d01d01d01d01d01d01d01
d01d01d01d02w01w01w01w01w01d03d01d01d01d01d06d04d04d04d04d04d07d01d01d01d01d01d01d01d01d01d01d01d01d01d01d01d01d01d01d01d01d01d01d01d01d01d01d01d01d01d01d01
d01d01d01d08d05d10w01d11d05d09d01d01d01d01d02w02w02w02w02w02d03d01d01d01d01d01d01d01d01d01d01d01d01d01d01d01d01d01d01d01d01d01d01d01d01d01d01d01d01d01d01d01
d01d01d01d01d01d02w01d03d01d01d01d01d01d01d02w01w01w01w01w01d03d01d01d01d01d01d01d01d01d01d01d01d01d01d01d01d01d06d04d04d04d04d04d04d04d07d01d01d01d01d01d01
d01d01d06d04d04d12w01d13d04d04d04d04d04d04d12w01w01w01w01w01d03d01d01d01d01d01d01d01d01d01d01d01d01d01d01d01d01d02w02w02w02s06w02w02w02d03d01d01d01d01d01d01
d01d01d02w02w02w02w01w02w02w02w02w02w02w02w02w01w01w01w01w01d03d01d01d01d01d01d01d01d01d01d01d01d01d01d01d01d01d02w01w01w01w01w01w01w01d03d01d01d01d01d01d01
d01d01d02w01w01w01w01w01w01w01w01w01w01w01w01w01w01w01w01w01d03d01d01d01d01d01d01d01d01d01d01d01d01d01d01d01d01d02w01w01w01w01w01w01w01d03d01d01d01d01d01d01
d01d01d08d05d05d10w01d11d05d05d05d05d05d05d10w01w01w01w01w01d03d01d01d01d01d01d01d01d01d01d01d01d01d01d01d01d01d02w01w01w01w01w01w01w01d03d01d01d01d01d01d01
d01d01d01d01d01d02w01d03d01d01d01d01d01d01d02w01w01w01w01w01d03d01d01d01d01d01d01d01d01d01d01d01d01d01d01d01d01d02s01w01w01w01w01w01w01d03d01d01d01d01d01d01
d01d01d06d04d04d12w01d13d04d07d01d01d01d01d02s01w01w01w01w01d03d01d01d01d01d01d01d01d01d01d01d01d01d01d01d01d01d02w01w01w01w01w01w01w01d03d01d01d01d01d01d01
d01d01d02w02w02w02w01w02w02d03d01d01d01d01d02w01w01w01w01w01d03d01d01d01d01d01d01d01d01d01d01d01d01d01d01d01d01d02w01w01w01w01w01w01w01d03d01d01d01d01d01d01
d01d01d02w01w01w01w01w01w01d03d01d01d01d01d08d05d10s02d11d05d09d01d01d01d01d01d01d01d01d01d01d01d01d01d01d01d01d02w01w01w01w01w01w01w01d03d01d01d01d01d01d01
d01d01d02w01w01w01w01w01w01d03d01d01d01d01d01d01d02w01d03d01d01d01d01d01d01d01d01d01d01d01d01d01d01d01d01d01d01d02w01w01w01w01w01w01w01d03d01d01d01d01d01d01
d01d01d08d05d05d05d05d05d05d09d01d01d01d01d06d04d12w01d13d04d07d01d01d01d01d01d01d01d01d01d01d01d01d01d01d01d01d02w01w01w01w01w01w01w01d03d01d01d01d01d01d01
d01d01d01d01d01d01d01d01d01d01d01d01d01d01d02w02w02w01w02w02d03d01d01d01d01d01d01d01d01d01d01d01d01d01d01d01d01d02w01w01w01w01w01w01w01d03d01d01d01d01d01d01
d01d01d01d01d01d01d01d01d01d01d01d01d01d01d02w01w01w01w01w01d03d01d01d01d01d01d01d01d01d01d01d01d01d01d01d01d01d02w01w01w01w01w01w01w01d03d01d01d01d01d01d01
d01d01d01d01d01d01d01d01d01d01d01d01d01d01d02w01w01w01w01w01d03d01d01d01d01d01d01d01d01d01d01d01d01d01d01d01d01d02w01w01w01w01w01w01w01d03d01d01d01d01d01d01
d01d01d01d01d01d01d01d01d01d01d01d01d01d01d08d05d10w01d11d05d09d01d01d01d01d01d01d01d01d01d01d01d01d01d01d01d01d08d05d05d10w01d11d05d05d09d01d01d01d01d01d01
d01d01d01d01d01d01d01d01d01d01d01d01d01d01d01d01d02w01d03d01d01d01d01d01d01d01d01d01d01d01d01d01d01d01d01d01d01d01d01d01d02w01d03d01d01d01d01d01d01d01d01d01
d01d01d01d01d01d01d01d01d01d01d01d01d06d04d04d04d12w01d13d04d07d01d01d01d01d01d01d01d01d01d01d01d01d01d01d01d01d01d01d01d02w01d03d01d01d01d01d01d01d01d01d01
d01d01d01d06d04d04d04d04d04d04d04d04d12w02w02w02w02w01w02w02d13d04d04d04d04d04d04d04d04d04d07d01d01d01d01d01d01d01d01d01d02w01d03d01d01d01d01d01d01d01d01d01
d01d01d01d02w02w02w02w02w02w02w02w02w02w01w01w01w01w01w01w01w02w02w02w02w02w02w02w02w02w02d03d01d01d01d01d01d01d01d01d01d02w01d03d01d01d01d01d01d01d01d01d01
d01d01d01d02w01w01w01w01w01d11d05d05d10w01w01w01w01w01w01w01d11d05d05d05d05d05d05d05d10w01d03d01d01d01d01d01d01d01d01d01d02w01d03d01d01d01d01d01d01d01d01d01
d01d01d01d02w01w01w01w01w01d03d01d01d08d05d10w01d11d05d05d05d09d01d01d01d01d01d01d01d02w01d03d01d01d01d01d01d01d01d06d04d12s05d13d04d07d01d01d01d01d01d01d01
d01d01d01d02s01w01w01w01w01d03d01d01d01d01d02w01d03d01d01d01d01d01d01d01d01d01d01d06d12w01d13d04d04d07d01d01d01d01d02w02w02w01w02w02d03d01d01d01d01d01d01d01
d01d01d01d02w01w01w01w01w01d03d01d01d01d06d12w01d13d04d07d01d01d01d01d01d01d01d01d02w02w01w02w02w02d03d01d01d01d01d02w01w01w01w01w01d03d01d01d01d01d01d01d01
d01d01d01d08d05d10s03d11d05d09d01d01d01d02w02w01w02w02d13d04d04d04d04d04d04d07d01d02w01w01w01w01w01d03d01d01d01d01d02s01w01w01w01w01d03d01d01d01d01d01d01d01
d01d01d01d01d01d02w01d03d01d01d01d01d01d02w01w01w01w01w02w02w02w02w02w02w02d03d01d02w01w01w01w01w01d03d01d01d01d01d02w01w01w01w01w01d03d01d01d01d01d01d01d01
d01d01d01d01d01d02w01d03d01d01d01d01d01d02w01w01w01w01d11d05d05d05d05d10w01d03d01d02w01w01w01w01w01d03d01d01d01d01d02w01w01w01w01w01d03d01d01d01d01d01d01d01
d01d01d01d01d01d02w01d03d01d01d01d01d01d02w01w01w01w01d03d01d01d01d01d02w01d03d01d08d05d05d05d05d05d09d01d01d01d01d08d05d10w01d11d05d09d01d01d01d01d01d01d01
d01d01d01d01d01d02w01d03d01d01d01d01d01d08d10w01d11d05d09d01d01d01d01d02w01d03d01d01d01d01d01d01d01d01d01d01d01d01d01d01d02w01d03d01d01d01d01d01d01d01d01d01
d01d01d01d01d01d02w01d03d01d01d01d01d01d01d02w01d03d01d01d01d01d01d01d02w01d03d01d01d01d01d01d01d01d01d01d01d01d01d01d01d02w01d03d01d01d01d01d01d01d01d01d01
d01d01d01d01d01d02w01d03d01d01d01d01d01d01d02w01d03d01d01d01d01d01d01d02w01d03d01d01d01d01d01d01d01d01d01d01d01d01d01d01d02w01d03d01d01d01d01d01d01d01d01d01
d01d01d01d01d01d02w01d03d01d01d01d01d01d01d02w01d03d01d01d01d01d01d01d02w01d03d01d01d01d01d01d01d01d01d01d01d01d01d01d01d02w01d13d04d04d04d04d04d04d07d01d01
d01d01d01d01d01d02w01d03d01d01d01d01d01d01d02w01d13d04d04d04d04d04d04d12w01d03d01d01d01d01d01d01d01d01d01d01d01d01d01d01d02w01w02w02w02w02w02w02w02d03d01d01
d01d01d01d01d01d02w01d03d01d01d01d01d01d01d02w01w01w02w02w02w02w02w02w02w01d03d01d01d01d01d01d01d01d01d01d01d01d01d01d01d08d05d05d05d05d05d05d10w01d03d01d01
d01d01d01d01d01d02w01d03d01d01d01d01d01d01d08d05d05d05d05d05d05d05d05d05d05d09d01d01d01d01d01d01d01d01d01d01d01d01d01d01d01d01d01d01d01d01d01d02w01d03d01d01
d01d01d01d01d01d02w01d03d01d01d01d01d01d01d01d01d01d01d01d01d01d01d01d01d01d01d01d01d01d01d01d01d01d01d01d01d01d01d01d01d01d01d01d01d01d01d01d02w01d03d01d01
d01d01d06d04d04d12w01d13d04d04d04d04d07d01d01d01d01d01d01d01d01d01d01d01d01d01d01d01d01d01d01d01d01d01d01d01d01d01d01d01d01d01d01d01d01d01d01d02w01d03d01d01
d01d01d02w02w02w02w01w02w02w02w02w02d03d01d01d01d01d06d04d04d04d04d04d07d01d01d01d01d01d01d01d01d01d01d01d01d01d01d01d01d01d01d01d01d01d01d01d02w01d03d01d01
d01d01d02w01w01w01w01w01w01w01w01w01d13d04d04d04d04d12w02w02w02w02w02d13d04d04d04d07d01d01d01d01d01d01d01d01d01d01d01d01d01d01d01d01d01d01d01d02w01d03d01d01
d01d01d02w01w01w01w01w01w01w01w01w01w02w02w02w02w02w02w01w01w01w01w01s04w02w02w01d03d01d01d01d01d01d01d01d01d01d01d01d01d01d01d01d01d01d01d01d02w01d03d01d01
d01d01d02w01w01w01w01w01w01w01w01w01d11d05d05d05d05d10w01s01w01w01w01d11d05d10w01d03d01d01d01d01d01d01d01d01d01d01d01d01d01d01d01d01d01d01d01d02w01d03d01d01
d01d01d02w01w01w01w01w01w01w01w01w01d03d01d01d01d01d08d05d05d05d05d05d09d01d02w01d13d04d04d04d04d04d07d01d01d01d01d01d01d01d01d01d01d01d01d01d02w01d03d01d01
d01d01d08d05d05d05d05d05d05d05d05d05d09d01d01d01d01d01d01d01d01d01d01d01d01d02w01w02w02w02w02w02w02d13d04d04d04d04d04d04d04d07d01d01d01d01d01d02w01d03d01d01
d01d01d01d01d01d01d01d01d01d01d01d01d01d01d01d01d01d01d01d01d01d01d01d01d01d02w01w01w01w01w01w01w01w02w02w02w02w02w02w02w02d03d01d01d01d01d01d02w01d03d01d01
d01d01d01d01d01d01d01d01d01d01d01d01d01d01d01d01d01d01d01d01d01d01d01d01d01d02w01w01w01w01w01w01w01d11d05d05d05d05d05d05d05d09d01d01d01d01d01d02w01d03d01d01
d01d01d01d01d01d01d01d01d06d04d04d04d04d04d04d04d04d04d04d04d04d04d04d04d04d12w01w01w01w01w01w01w01d03d01d01d01d01d01d01d01d01d01d01d01d01d01d02w01d03d01d01
d01d01d01d01d01d01d01d01d02w02w02w02w02w02w02w02w02w02w02w02w02w02w02w02w02w02w01w01w01w01w01w01w01d13d04d04d04d04d04d04d04d04d04d04d07d01d01d02w01d03d01d01
d01d01d01d01d01d01d01d01d08d05d05d05d05d05d05d05d05d05d05d05d05d05d05d05d05d10w01w01w01w01w01w01w01w02w02w02w02w02w02w02w02w02w02w02d03d01d01d02w01d03d01d01
d01d01d01d01d01d01d01d01d01d01d01d01d01d01d01d01d01d01d01d01d01d01d01d01d01d02w01w01w01w01w01w01w01d11d05d05d05d05d05d05d05d05d10w01d03d01d01d02w01d03d01d01
d01d01d01d01d01d01d01d01d01d01d01d01d01d01d01d06d04d04d04d04d04d04d04d04d04d12w01w01w01w01w01w01w01d03d01d01d01d01d01d01d01d01d02w01d03d01d01d02w01d03d01d01
d01d01d01d01d01d01d01d01d01d01d01d01d01d01d01d02w02w02w02w02w02w02w02w02w02w02w01w01w01w01w01w01w01d03d01d06d04d04d04d04d07d01d02w01d03d01d01d02w01d03d01d01
d01d01d01d01d01d01d01d01d01d01d01d01d01d01d01d02w01d11d05d05d05d05d05d05d05d10w01w01w01w01w01w01w01d03d01d02w02w02w02w02d13d04d12w01d03d01d01d02w01d03d01d01
d01d01d01d01d01d01d01d01d01d01d01d01d01d01d01d02w01d03d01d01d01d01d01d01d01d02w01w01w01w01w01w01w01d03d01d02w01w01w01w01w02w02w02w01d03d01d01d02w01d03d01d01
d01d01d01d01d01d01d01d01d01d01d01d01d01d01d01d02w01d03d01d01d01d01d01d01d01d08d10w01d11d05d10w01d11d09d01d02w01w01w01w01d11d05d05d05d09d01d01d02w01d03d01d01
d01d01d01d01d01d01d01d01d01d01d01d01d01d01d01d02w01d03d01d01d01d01d01d01d01d01d02w01d03d01d02w01d03d01d01d08d05d05d05d05d09d01d01d01d01d01d01d02w01d03d01d01
d01d01d01d01d01d01d01d01d01d01d01d01d01d01d01d02w01d13d04d04d04d04d04d04d04d04d12w01d03d01d02w01d03d01d01d01d01d01d01d01d01d01d01d01d01d01d01d02w01d03d01d01
d01d01d01d01d01d01d01d01d01d01d01d01d01d01d01d02w01w02w02w02w02w02w02w02w02w02w02w01d03d01d02w01d13d04d04d04d04d04d04d04d04d04d04d04d04d04d04d12w01d03d01d01
d01d01d01d01d01d01d01d01d01d01d01d01d01d01d01d08d05d05d05d05d05d05d05d05d05d05d05d05d09d01d02w01w02w02w02w02w02w02w02w02w02w02w02w02w02w02w02w02w01d03d01d01
d01d01d01d01d01d01d01d01d01d01d01d01d01d01d01d01d01d01d01d01d01d01d01d01d01d01d01d01d01d01d08d05d05d05d05d05d05d05d05d05d05d05d05d05d05d05d05d05d05d09d01d01
d01d01d01d01d01d01d01d01d01d01d01d01d01d01d01d01d01d01d01d01d01d01d01d01d01d01d01d01d01d01d01d01d01d01d01d01d01d01d01d01d01d01d01d01d01d01d01d01d01d01d01d01
