11111111111111111111111111111111111111111111111111
11111111111111111111111111111111111111111111111111
11110000011111111111111111111111111111111111111111
11110000011111111111111111111111111111111111111111
11110000011111111111111111111111111111111111111111
11111101111111100000111111111111111111111111111111
11111101111111100000111111111111111111111111111111
11111101111111100000111111111111111110007000111111
11100000000000000000111111111111111110000000111111
11100000000000000000111111111111111110000000111111
11111101111111100000111111111111111110000000111111
11100000001111100000111111111111111112000000111111
11100000001111120000111111111111111110000000111111
11100000001111100000111111111111111110000000111111
11111111111111111311111111111111111110000000111111
11111111111111111011111111111111111110000000111111
11111111111111100000111111111111111110000000111111
11111111111111100000111111111111111110000000111111
11111111111111100000111111111111111110000000111111
11111111111111100000111111111111111110000000111111
11111111111111111011111111111111111111110111111111
11111111111111111011111111111111111111110111111111
11111111111110000000111111111111111111110111111111
11111000000000000000000000000111111111110111111111
11111000011110000000111111110111111111110111111111
11111000011111101111111111110111111111110111111111
11111200011111101111111111100000111111006001111111
11111000011111101111111111100000111111000001111111
11111141111111000011111111100000111111200001111111
11111101111111000000000001100000111111000001111111
11111101111111000011111101111111111111000001111111
11111101111111000011111101111111111111110111111111
11111101111111101111111101111111111111110111111111
11111101111111101111111101111111111111110111111111
11111101111111101111111101111111111111110111111111
11111101111111101111111101111111111111110111111111
11111101111111101111111101111111111111110000001111
11111101111111100000000001111111111111111111101111
11111101111111111111111111111111111111111111101111
11111101111111111111111111111111111111111111101111
11111101111111111111111111111111111111111111101111
11100000000011111111111111111111111111111111101111
11100000000011111100000111111111111111111111101111
11100000000000000000000005011111111111111111101111
11100000000011111100002111011111111111111111101111
11100000000011111111111111000000111111111111101111
11111111111111111111111111000000000000011111101111
11111111111111111111111111000000111111111111101111
11111111111111111111111111000000111111111111101111
11111111100000000000000000000000111111111111101111
11111111111111111111111111000000000000000111101111
11111111111111111111111111000000111111110111101111
11111111111111110000000000000000111111110111101111
11111111111111110111111111000000110000110111101111
11111111111111110111111111000000110000000111101111
11111111111111110111111111101101110000111111101111
11111111111111110111111111101101111111111111101111
11111111111111110000000000001101111111111111101111
11111111111111111111111111111100000000000000001111
11111111111111111111111111111111111111111111111111
11111111111111111111111111111111111111111111111111